a side-effect => efecto secundario
fall back => retroceder
attemp => intentar
further => promover
pitfalls => trampas
major topic area => área temática principal
at a glance => de un vistazo
proper ray => rayo apropiado
aimed => dirigir, apuntado
the bulk => la mayor parte
along with => junto con
to that end => con ese fin
through all => a traves de todo
research => investigar
proving => demostrando, provando
your command => tu dominio
broad => amplia, ancho
your nastery => tu dominio
throughout => en todo, todo
painstaking => minusioso, cuidadoso
companion content => contenido complementario
every time you come across => cada vez que te encuentras
effort => esfuerzo
accuracy => exactitud
check back often => visite con frecuencia
submitted errata => errata enviada
offered => ofrecida
lets keep => mantengamos
to build your resume => elaborar su curriculum
level of expertise => nivel de experiencia
on the job experience => experiencia en el trabajo
product knowledge => conocimiento del producto
although => a pesar de que
you augment => aumentes
might use => podrías usar
curriculum course => curso curricular
on publicly available information => info pública disponible
to thank => agradecer
keeping me on the straight and narrow => manteniendome en la estrecha y recta
for putting in the missing words => por poner las palabras que faltan
for stopping me from writing silly things => detenerme de escribir cosas tontas
endless => interminables
spent => gasto, gastar
to a succession of students => sucesión de estudiantes
any spare time => algún tiempo libre
he reckons that => el considera que
he claims to know => el dice saber
an insight into the => una visión de  la
wacky world => mundo loco, chiflado
early => temprano
however => sin embargo
carry twice => llevar dos veces
as many passengers as one => tantos pasajeros como uno
permorming => realizando
spell check => revisión ortografica
the advent => la llegada de
genuine => autentico
extra layer => capa extra
meaningful way => de manera significativa
regarding => respecto a
diners => comensales
meal => comida
dish is in the oven baking => plato esta en el horno para hornear
performance => rendimiento
allocate => asignar
desserts => postres
pastry => pasteleria
multi threaded => multi hilo
delayed => retrasada
perhaps => quizas/tal vez
device => dispositivo
mass => masivo
as long as no further sorting is performed within the query itself => siempre que no se realizen mas ordenamientos dentro de la propia consulta
It strikes => encuentra
though it is not suitable => aunque no es adecuada
yielded => producido
hint => pista/sugerencia
will buffer => va a amortiguar
likely result => resutltado probable
assumptions => supocisiones
concerning wich  => sobre que
spawn => generar
concurrent => concurrente/simultanea
remarks => observaciones
regardless => sin importar/independientemente
due => debido
amongst => entre
whether => ya sea
otherwise => de otra manera
still likely => todavía es probable
beyond => mas allá
tiny => diminuto, pequeñito
behaviour => funcionamiento, comportamiento
to further inform => para informar mas
issue => problema, hecho
arise => surgir
disrupt => interrumpir, desorganizar
as close to "sutantivo" as possible => lo mas cerca posible de "sustantivo"
so far => hasta aqui
Note that => tenga encuenta que
nominated => propuesto / nombrado
with each successive stage starting => con cada etapa sucesiva iniciando
detached => desprendido / separado
therefore => por lo tantos
rather => mas bien/bastante/algo
there are => existen
to be aware => estar concientes
foreground => de primer plano
scheduling => programar/planificar
higher priority request => solicitud de mayor prioridad
a greater => una mayor
is no longer required => ya no es necesario
overwhelm => abrumar/agobiar
idle => libre, ocioso, desocupado